1111111111111111
1000000000000001
1000000000000001
1002220002200001
1200000000000001
1000000000000001
1020000000000001
1002000000000001
1000000002222001
1000000000000001
1000000000000021
1000000000200001
1000002220002221
1000021111111111
1000211111111111
1222111111111111