1111111111111111
1000000000000001
1000000000000001
1000220000220001
1200100000010021
1000130000310001
1002122222222001
1000000000000001
1200000000000021
1000222002220001
1000000000000001
1200000000000021
1122220000222211
1000000000000001
1000000220000001
1222222112222221