1111111111111111
1000000000000031
1000000000000001
1000000000000221
1000020022200001
1000000000000001
1020000000000001
1002004000000001
1000002002222001
1000000000000001
1000000000000021
100000040#2#0001
100000222***2221
1000021111111111
1000211111111111
1222111111111111