1111111111111111
1000000000000001
1000000000000001
1400220000220041
1200100000010021
1000130400310001
1002122222222001
1000000000000001
1200400000040021
1002222002222001
1400000000000041
1200000000000021
1122220000222211
1000000000000001
1000000220000001
1222222112222221