1111111111111111
1000000000000001
1000000000000021
10*2***22**2**21
1022222222212211
1002130000310001
1000022222222001
1000000022222221
1200000000000021
1000222002220001
1000000000000001
1200000000000021
1122220000222211
1000000000000001
1000000220000001
1222222112222221