1111111111111111
1400000000000001
1000004000000001
1200022222222221
1120000000000001
1112000000000001
1110022**2400241
1100031**1222111
1100001**1004011
1122221**1300011
1100000112002011
1140000000200011
1122200000000111
1000000000000041
1000402222220001
1221111111111111