1111111111111111
1000000000000001
1000000000000001
1002200000022001
1001000000001001
1021300000031201
1001222222221001
1000000000000001
1200000000000021
1000222002220001
1000000000000001
1200000000000021
1122220000222211
1000000000000001
1000000220000001
1222222112222221