1111111111111111
1000000000000001
1000400000040001
1000200000020001
1220000000000221
1000400000040001
1040140000010401
1300120002210031
1000100020010001
1204100200014021
1002100000412001
1000120000210001
1204100000014021
1002100220012001
1000100000010001
1***12222221***1