1111111111111111
1400000000000001
1000004000000001
1200022222222221
1120000000000001
1112000000000001
1110020004002421
1130012020221111
1100011*1*134011
1122211111100011
1100000111120011
1140000000000011
1122200000000211
1000000000000041
1000402222220001
1222221111112221