1111111111111111
1000000000000031
1000000000000001
1000000004000221
1000020022220001
1000000000000001
1020000000000001
1002004000000001
1000002002222001
1000000000000001
1000000000000021
100000040#0#0001
1000002220202221
100002111***1111
1000211111111111
1222111111111111