1111111111111111
1000000000000031
1000000000000001
1000000000040221
1000000040220001
1000040220000001
1000220000000001
1200000000000001
1000000004000001
1020040000000001
100202222*220001
1000000000002001
1000004000400041
1000002000200021
1000200020002001
12221**********1